{
"stageNum":0,
"moveCount": 30,
"mapSize": 11,
"basicBlocks": [200000,200001,200002,200003,200004],
"multimapOrder": [ 0 ],
"tiles":[
32,32,32,32,32,32,32,32,32,
30,30,30,30,30,30,30,30,30,
30,30,30,30,30,30,30,30,30,
30,30,30,30,30,30,30,30,30,
30,30,30,30,30,30,30,30,30,
30,30,30,30,30,30,30,30,30,
30,30,30,30,30,30,30,30,30,
30,30,30,30,30,30,30,30,30,
33,33,33,33,33,33,33,33,33],
"missions":[-1],
"object_XY": [-1],
"object_EtcID": [-1],
"object_ColorHp": [-1]
}